111111
1PC001
100E01
111111
100001
111111
