1111111111
1P00111111
11CE1C0001
1111110001
1111111111
