1111111111
1000111111
11100C0001
1111110E01
1111111111
