1111111111
1P00111111
11101C0001
1111110E01
1111111111
