111111111
1P0000001
1100C0C01
1000000E1
111111111
