1111111111111111111111111111111111
1000000000000000C0111C0000000000E1
1C100101C00000001010010001C0010101
1110010010001010001001001110010101
1000000000000000001001000001000001
1000000000000000001000000001000001
1000C00111000000001001000001000001
10001001C0000C0000000100C001011C01
1000111100001110001001011101001101
1000000000000100001C01000001000001
1000000001110000001101000001001101
1P000000011C0000000000011100001C01
1111111111111111111111111111111111
